School Code,District,School Name,# STUDENTS ENROLLED,# STUDENTS ENROLLED PRIOR TO SECONDARY LEVEL,# STUDENTS ENROLLED AT SECONDARY LEVEL
10405,Abington,Frolio Middle School,322,322,0
10505,Abington,Abington High,20,1,19
30025,Acushnet,Acushnet Elementary School,2,2,0
30305,Acushnet,Albert F Ford Middle School,416,416,0
50303,Agawam,Roberta G. Doering School,498,498,0
50405,Agawam,Agawam Junior High,296,296,0
50505,Agawam,Agawam High,131,0,131
70005,Amesbury,Amesbury Elementary,304,304,0
70010,Amesbury,Charles C Cashman Elementary,362,362,0
70013,Amesbury,Amesbury Middle,401,400,1
70505,Amesbury,Amesbury High,188,0,188
80009,Amherst,Crocker Farm Elementary,333,333,0
80020,Amherst,Fort River Elementary,327,327,0
80050,Amherst,Wildwood Elementary,400,400,0
90505,Andover,Andover High,181,0,181
100410,Arlington,Ottoson Middle,1196,1196,0
100505,Arlington,Arlington High,116,0,116
140010,Ashland,Henry E Warren Elementary,612,612,0
140015,Ashland,David Mindess,623,623,0
140505,Ashland,Ashland High,119,0,119
160001,Attleboro,A. Irvin Studley Elementary School,447,447,0
160035,Attleboro,Thomas Willett Elementary School,459,459,0
160040,Attleboro,Hyman Fine Elementary School,459,459,0
160045,Attleboro,Hill-Roberts Elementary School,472,472,0
160050,Attleboro,Peter Thacher Elementary School,389,389,0
160505,Attleboro,Attleboro High,46,0,46
170305,Auburn,Auburn Middle,247,247,0
170505,Auburn,Auburn Senior High,220,0,220
180010,Avon,Ralph D Butler,232,232,0
180510,Avon,Avon Middle High School,117,56,61
200025,Barnstable,Hyannis West Elementary,1,1,0
200045,Barnstable,West Villages Elementary School,1,1,0
200315,Barnstable,Barnstable Intermediate School,648,648,0
200505,Barnstable,Barnstable High,21,0,21
230505,Bedford,Bedford High,143,0,143
240025,Belchertown,Jabish Middle School,339,339,0
240505,Belchertown,Belchertown High,193,0,193
250020,Bellingham,South Elementary,1,1,0
250315,Bellingham,Bellingham Memorial School,346,346,0
250505,Bellingham,Bellingham High School,184,184,0
250510,Bellingham,Keough Memorial Academy,1,1,0
260505,Belmont,Belmont High,47,0,47
270010,Berkley,Berkley Community School,467,467,0
270305,Berkley,Berkley Middle School,388,388,0
280005,Berlin,Berlin Memorial,92,92,0
300305,Beverly,Briscoe Middle,948,948,0
300505,Beverly,Beverly High,103,0,103
310005,Billerica,Thomas Ditson,538,538,0
310007,Billerica,Frederick J Dutile,290,290,0
310012,Billerica,John F Kennedy,319,319,0
310015,Billerica,Parker,486,486,0
310026,Billerica,Hajjar Elementary,473,473,0
310030,Billerica,Eugene C Vining,192,192,0
310305,Billerica,Marshall Middle School,411,411,0
310310,Billerica,Locke Middle,344,344,0
310505,Billerica,Billerica Memorial High School,202,0,202
350004,Boston,Lyon K-8,102,102,0
350008,Boston,Dr. Catherine Ellison-Rosa Parks Early Ed School,1,1,0
350013,Boston,Jackson Mann,521,521,0
350021,Boston,Beethoven,299,299,0
350052,Boston,Charles Sumner,503,503,0
350072,Boston,David A Ellis,383,383,0
350074,Boston,Dearborn,255,255,0
350080,Boston,Donald Mckay,698,698,0
350096,Boston,Eliot Elementary,431,431,0
350116,Boston,Franklin D Roosevelt,133,133,0
350122,Boston,George H Conley,96,96,0
350135,Boston,Henry Grew,236,236,0
350138,Boston,O W Holmes,2,2,0
350141,Boston,Hugh Roe O'Donnell,250,250,0
350146,Boston,James Condon Elementary,699,699,0
350153,Boston,James W Hennigan,284,284,0
350154,Boston,James J Chittick,1,1,0
350156,Boston,James Otis,351,351,0
350166,Boston,John F Kennedy,351,351,0
350167,Boston,UP Academy Holland,2,2,0
350181,Boston,Joseph P Tynan,1,1,0
350182,Boston,Joseph J Hurley,36,36,0
350183,Boston,Joseph Lee,126,126,0
350200,Boston,Harvard-Kent,472,472,0
350215,Boston,Manassah E Bradley,245,245,0
350226,Boston,Mattahunt,506,506,0
350227,Boston,Mather,550,550,0
350229,Boston,Maurice J Tobin,436,436,0
350231,Boston,Michael J Perkins,213,213,0
350237,Boston,Mozart,22,22,0
350240,Boston,Richard J Murphy,475,475,0
350243,Boston,Nathan Hale,159,159,0
350255,Boston,Oliver Hazard Perry,170,170,0
350258,Boston,William H Ohrenberger,610,610,0
350262,Boston,Lyndon,203,203,0
350268,Boston,Paul A Dever,268,268,0
350286,Boston,Josiah Quincy,629,629,0
350302,Boston,Samuel Adams,239,239,0
350304,Boston,Samuel W Mason,76,76,0
350308,Boston,Sarah Greenwood,436,436,0
350326,Boston,Gardner Pilot Academy,1,1,0
350328,Boston,Thomas J Kenny,2,2,0
350346,Boston,Warren-Prescott,53,53,0
350360,Boston,William Ellery Channing,207,207,0
350363,Boston,William McKinley,78,71,7
350366,Boston,William E Russell,1,1,0
350370,Boston,William Monroe Trotter,455,455,0
350374,Boston,Winship Elementary,179,179,0
350376,Boston,King K-8,1,1,0
350377,Boston,Higginson/Lewis K-8,1,1,0
350378,Boston,Mildred Avenue K-8,1,1,0
350380,Boston,Young Achievers,180,180,0
350390,Boston,Blackstone,410,410,0
350426,Boston,Dr. William Henderson Upper,289,289,0
350430,Boston,Clarence R Edwards Middle,173,173,0
350445,Boston,Washington Irving Middle,250,250,0
350505,Boston,Brighton High,93,76,26
350507,Boston,Boston International High School,218,181,39
350515,Boston,Charlestown High,65,65,0
350518,Boston,Community Academy,2,2,0
350522,Boston,Excel High School,122,62,60
350525,Boston,Jeremiah E Burke High,70,70,0
350530,Boston,East Boston High,232,232,0
350537,Boston,Madison Park High,64,6,58
350540,Boston,Fenway High School,17,17,0
350541,Boston,Another Course To College,1,1,0
350542,Boston,New Mission High School,81,73,9
350543,Boston,Greater Egleston Community High School,2,0,2
350545,Boston,,133,85,54
350546,Boston,Boston Arts Academy,16,16,0
350548,Boston,Boston Adult Academy,7,0,7
350549,Boston,Margarita Muniz Academy,67,0,67
350558,Boston,Boston Community Leadership Academy,101,0,101
350560,Boston,Boston Latin,108,108,0
350565,Boston,Quincy Upper School,47,0,47
350575,Boston,O'Bryant School Math/Science,285,134,179
350579,Boston,Urban Science Academy,115,87,40
350581,Boston,Community Academy of Science and Health,33,22,11
350651,Boston,Dorchester Academy,43,43,0
350655,Boston,Lyon Upper 9-12,39,29,10
350656,Boston,Mario Umana Academy,67,67,0
350657,Boston,TechBoston Academy,361,307,78
350658,Boston,West Roxbury Academy,49,49,0
350750,Boston,Horace Mann School for the Deaf,59,59,0
350755,Boston,Boston Collaborative High School,33,32,1
360005,Bourne,Bournedale Elementary School,355,355,0
360010,Bourne,Peebles Elementary School,343,343,0
360325,Bourne,Bourne Middle School,517,517,0
360505,Bourne,Bourne High School,1,0,1
390005,Boylston,Boylston Elementary,265,265,0
400305,Braintree,East Middle School,229,229,0
400310,Braintree,South Middle School,226,226,0
400505,Braintree,Braintree High,60,0,60
410005,Brewster,Stony Brook Elementary,227,227,0
410010,Brewster,Eddy Elementary,235,235,0
440023,Brockton,Edgar B Davis,1,1,0
440080,Brockton,Frederick Douglass Academy,1,0,1
440415,Brockton,South Middle School,163,163,0
440420,Brockton,West Middle School,2,2,0
440421,Brockton,Ashfield Middle School,1,1,0
440422,Brockton,Joseph F. Plouffe Academy,687,687,0
440505,Brockton,Brockton High,462,0,462
440520,Brockton,Edison Academy,2,0,2
450005,Brookfield,Brookfield Elementary,1,1,0
460020,Brookline,Michael Driscoll,66,66,0
460035,Brookline,William H Lincoln,53,53,0
460040,Brookline,Pierce,86,86,0
460045,Brookline,John D Runkle,58,58,0
460505,Brookline,Brookline High,129,0,129
480303,Burlington,Marshall Simonds Middle,767,767,0
480505,Burlington,Burlington High,116,0,116
490305,Cambridge,Cambridge Street Upper School,2,2,0
490506,Cambridge,Cambridge Rindge and Latin,103,0,103
500305,Canton,Wm H Galvin Middle,723,723,0
500505,Canton,Canton High,48,0,48
520015,Carver,Carver Elementary School,1,1,0
520405,Carver,Carver Middle/High School,116,82,34
560305,Chelmsford,Col Moses Parker School,350,350,0
560310,Chelmsford,McCarthy Middle School,409,409,0
560505,Chelmsford,Chelmsford High,125,0,125
570030,Chelsea,Edgar A Hooks Elementary,1,1,0
570035,Chelsea,George F. Kelly Elementary,1,1,0
570045,Chelsea,Eugene Wright Science and Technology Academy,488,488,0
570050,Chelsea,Clark Avenue School,534,534,0
570055,Chelsea,Joseph A. Browne School,453,453,0
570505,Chelsea,Chelsea High,443,0,443
610003,Chicopee,Barry,419,419,0
610010,Chicopee,Belcher,258,258,0
610015,Chicopee,Bowe,415,415,0
610022,Chicopee,Litwin,389,389,0
610065,Chicopee,Streiber Memorial School,283,283,0
610090,Chicopee,Gen John J Stefanik,373,373,0
610305,Chicopee,Bellamy Middle,278,278,0
610310,Chicopee,Dupont Middle,366,366,0
610505,Chicopee,Chicopee High,80,0,80
610510,Chicopee,Chicopee Comprehensive High School,183,0,183
630010,Clarksburg,Clarksburg Elementary,121,121,0
640050,Clinton,Clinton Elementary,476,476,0
640305,Clinton,Clinton Middle School,248,248,0
640505,Clinton,Clinton Senior High,90,4,86
650010,Cohasset,Joseph Osgood,342,342,0
650505,Cohasset,Cohasset Middle/High School,116,0,116
670305,Concord,Concord Middle,390,390,0
680005,Conway,Conway Grammar,121,121,0
710030,Danvers,Riverside,1,1,0
710305,Danvers,Holten Richmond Middle School,543,543,0
710505,Danvers,Danvers High,268,0,268
720050,Dartmouth,Dartmouth Middle,821,821,0
720505,Dartmouth,Dartmouth High,18,0,18
730305,Dedham,Dedham Middle School,596,596,0
730505,Dedham,Dedham High,52,0,52
740015,Deerfield,Deerfield Elementary,362,362,0
770505,Douglas,Douglas High School,77,0,77
780005,Dover,Chickering,477,477,0
790030,Dracut,Greenmont Avenue,1,1,0
790045,Dracut,George H. Englesby Elementary School,1,1,0
790410,Dracut,Justus C. Richardson Middle School,304,304,0
790505,Dracut,Dracut Senior High,208,0,208
820004,Duxbury,Alden School,1,1,0
820505,Duxbury,Duxbury High,37,0,37
830005,East Bridgewater,Central,396,396,0
830010,East Bridgewater,Gordon W Mitchell,686,686,0
830505,East Bridgewater,East Bridgewater JR./SR. High School,177,0,177
850005,Eastham,Eastham Elementary,170,170,0
860010,Easthampton,Maple,1,1,0
860505,Easthampton,Easthampton High,124,0,124
870305,East Longmeadow,Birchland Park,118,118,0
870505,East Longmeadow,East Longmeadow High,139,0,139
880003,Easton,Center School,241,241,0
880015,Easton,Parkview Elementary,293,293,0
880020,Easton,Moreau Hall,223,223,0
880025,Easton,Richardson Olmsted School,829,829,0
880405,Easton,Easton Middle School,646,646,0
880505,Easton,Oliver Ames High,25,0,25
890005,Edgartown,Edgartown Elementary,342,342,0
910030,Erving,Erving Elementary,139,139,0
930010,Everett,Sumner G. Whittier School,620,620,0
930018,Everett,Madeline English School,838,838,0
930028,Everett,George Keverian School,919,919,0
930030,Everett,Devens School,2,2,0
930038,Everett,Lafayette School,938,938,0
930058,Everett,Parlin School,920,920,0
930505,Everett,Everett High,72,0,72
940030,Fairhaven,Leroy Wood,352,352,0
940305,Fairhaven,Hastings Middle,417,417,0
940505,Fairhaven,Fairhaven High,32,0,32
950011,Fall River,Mary Fonseca Elementary School,1,1,0
950065,Fall River,William S Greene,1,1,0
950315,Fall River,Morton Middle,2,2,0
950325,Fall River,Resiliency Preparatory School,1,0,1
950505,Fall River,B M C Durfee High,156,0,156
960005,Falmouth,East Falmouth Elementary,268,268,0
960015,Falmouth,Teaticket,280,280,0
960020,Falmouth,Mullen-Hall,446,446,0
960030,Falmouth,North Falmouth Elementary,317,317,0
960305,Falmouth,Morse Pond School,590,590,0
960405,Falmouth,Lawrence,279,279,0
960505,Falmouth,Falmouth High,140,0,140
970048,Fitchburg,Memorial Intermediate,516,516,0
970315,Fitchburg,Arthur M Longsjo Middle School,249,249,0
970505,Fitchburg,Fitchburg High,187,0,187
970510,Fitchburg,Goodrich Academy,1,0,1
980005,Florida,Abbott Memorial,70,70,0
990405,Foxborough,John J Ahern,469,466,7
990505,Foxborough,Foxborough High,99,0,99
1000515,Framingham,Framingham High School,188,0,188
1010040,Franklin,Annie Sullivan Middle School,457,457,0
1010310,Franklin,Remington Middle,456,456,0
1010405,Franklin,Horace Mann,463,463,0
1010505,Franklin,Franklin High,173,10,163
1030405,Gardner,Gardner Middle School,526,526,0
1030505,Gardner,Gardner High,1,0,1
1050010,Georgetown,Penn Brook,690,690,0
1050305,Georgetown,Georgetown Middle School,192,192,0
1050505,Georgetown,Georgetown High School,137,0,137
1070505,Gloucester,Gloucester High,195,0,195
1090005,Gosnold,Cuttyhunk Elementary,2,2,0
1100030,Grafton,North Street Elementary School,593,593,0
1100200,Grafton,Millbury Street Elementary School,674,674,0
1100305,Grafton,Grafton Middle,478,478,0
1100505,Grafton,Grafton High School,70,0,70
1110004,Granby,East Meadow,169,169,0
1110010,Granby,West Street,174,174,0
1110505,Granby,Granby Jr Sr High School,182,130,52
1140010,Greenfield,Federal Street School,242,242,0
1140025,Greenfield,Discovery School at Four Corners,239,239,0
1140030,Greenfield,Green River,6,6,0
1140305,Greenfield,Greenfield Middle,296,296,0
1170505,Hadley,Hopkins Academy,58,49,9
1180005,Halifax,Halifax Elementary,253,253,0
1210005,Hancock,Hancock Elementary,33,33,0
1220004,Hanover,Cedar Elementary,362,362,0
1220005,Hanover,Center Elementary,352,352,0
1220015,Hanover,Sylvester,227,227,0
1220305,Hanover,Hanover Middle,834,834,0
1220505,Hanover,Hanover High,21,0,21
1250005,Harvard,Hildreth Elementary School,425,425,0
1250505,Harvard,Bromfield,31,22,9
1270005,Hatfield,Hatfield Elementary,222,222,0
1270505,Hatfield,Smith Academy,38,38,0
1280033,Haverhill,Haverhill Alternative School,7,0,7
1280073,Haverhill,TEACH,6,0,6
1280505,Haverhill,Haverhill High,518,0,518
1310410,Hingham,Hingham Middle School,352,352,0
1310505,Hingham,Hingham High,226,0,226
1330018,Holbrook,John F Kennedy,1,1,0
1330505,Holbrook,Holbrook Jr Sr High,186,186,0
1360007,Holliston,Miller School,679,679,0
1360505,Holliston,Holliston High,10,0,10
1370015,Holyoke,Lt Elmer J McMahon Elementary,378,378,0
1370040,Holyoke,Kelly Elementary,137,137,0
1370045,Holyoke,E N White Elementary,432,432,0
1370055,Holyoke,Lt Clayre Sullivan Elementary,303,303,0
1370060,Holyoke,Maurice A Donahue Elementary,412,412,0
1370505,Holyoke,Holyoke High,441,0,441
1380505,Hopedale,Hopedale Jr Sr High,98,84,14
1390015,Hopkinton,Hopkins Elementary School,499,499,0
1390305,Hopkinton,Hopkinton Middle School,572,572,0
1390505,Hopkinton,Hopkinton High,55,0,55
1410007,Hudson,Mulready Elementary,236,236,0
1410015,Hudson,Forest Avenue Elementary,333,333,0
1410030,Hudson,C A Farley,471,471,0
1410505,Hudson,Hudson High,281,208,92
1420015,Hull,Lillian M Jacobs,359,359,0
1420305,Hull,Memorial Middle,1,1,0
1420505,Hull,Hull High,10,0,10
1440505,Ipswich,Ipswich High,20,0,20
1450020,Kingston,Kingston Intermediate,580,580,0
1480005,Lanesborough,Lanesborough Elementary,202,202,0
1490002,Lawrence,Lawlor Early Childhood Center,1,1,0
1490004,Lawrence,South Lawrence East Elementary School,1,1,0
1490018,Lawrence,Robert Frost,590,590,0
1490048,Lawrence,Oliver Partnership School,1,1,0
1490053,Lawrence,Edward F. Parthum,627,627,0
1490085,Lawrence,Spark Academy,1,1,0
1490515,Lawrence,Lawrence High School,101,0,101
1490537,Lawrence,School for Exceptional Studies,8,0,8
1500505,Lee,Lee Middle/High School,139,96,43
1510505,Leicester,Leicester High,141,0,141
1520015,Lenox,Morris,254,254,0
1520505,Lenox,Lenox Memorial High,146,130,16
1530045,Leominster,Samoset School,1,1,0
1530505,Leominster,Leominster High School,15,0,15
1530605,Leominster,Center For Technical Education Innovation,38,0,38
1540005,Leverett,Leverett Elementary,112,112,0
1550305,Lexington,Jonas Clarke Middle,307,307,0
1550310,Lexington,Wm Diamond Middle,356,356,0
1550505,Lexington,Lexington High,348,0,348
1570025,Lincoln,Lincoln School,401,401,0
1570305,Lincoln,Hanscom Middle,237,237,0
1580305,Littleton,Littleton Middle School,350,350,0
1580505,Littleton,Littleton High School,111,0,111
1590005,Longmeadow,Blueberry Hill,424,424,0
1590010,Longmeadow,Center,402,402,0
1590017,Longmeadow,Glenbrook Middle,314,314,0
1590025,Longmeadow,Wolf Swamp Road,343,343,0
1590305,Longmeadow,Williams Middle,341,341,0
1590505,Longmeadow,Longmeadow High,58,0,58
1600018,Lowell,Pyne Arts,469,469,0
1600030,Lowell,Charles W Morey,2,2,0
1600090,Lowell,Bartlett Community Partnership,454,454,0
1600310,Lowell,B.F. Butler Middle School,5,5,0
1600315,Lowell,James S Daley Middle School,608,608,0
1600320,Lowell,Leblanc Therapeutic Day School,1,1,0
1600330,Lowell,Henry J Robinson Middle,555,555,0
1600340,Lowell,James Sullivan Middle School,465,465,0
1600345,Lowell,Dr An Wang School,682,682,0
1600360,Lowell,Kathryn P. Stoklosa Middle School,2,2,0
1600505,Lowell,Lowell High,192,0,192
1600515,Lowell,The Career Academy,13,0,13
1610023,Ludlow,Veterans Park Elementary,358,358,0
1610305,Ludlow,Paul R Baird Middle,162,162,0
1610505,Ludlow,Ludlow Senior High,60,0,60
1620305,Lunenburg,Lunenburg Middle School,118,118,0
1620505,Lunenburg,Lunenburg High,1,0,1
1630005,Lynn,Washington Elementary School,1,1,0
1630035,Lynn,Cobbet Elementary,1,1,0
1630085,Lynn,Sewell-Anderson,1,1,0
1630100,Lynn,Tracy,1,1,0
1630305,Lynn,Thurgood Marshall Mid,2,2,0
1630505,Lynn,Classical High,384,0,384
1630510,Lynn,Lynn English High,360,0,360
1630525,Lynn,Fecteau-Leary Junior/Senior High School,2,0,2
1630605,Lynn,Lynn Vocational Technical Institute,3,0,3
1640405,Lynnfield,Lynnfield Middle School,525,525,0
1640505,Lynnfield,Lynnfield High,15,0,15
1650003,Malden,Beebe,348,348,0
1650013,Malden,Ferryway,378,378,0
1650027,Malden,Forestdale,217,217,0
1650047,Malden,Linden,382,382,0
1650057,Malden,Salemwood,342,342,0
1650505,Malden,Malden High,63,0,63
1670007,Mansfield,Everett W Robinson,1,1,0
1670014,Mansfield,Jordan/Jackson Elementary,1,1,0
1670035,Mansfield,Harold L Qualters Middle,293,293,0
1670505,Mansfield,Mansfield High,214,0,214
1680300,Marblehead,Marblehead Veterans Middle School,454,454,0
1680505,Marblehead,Marblehead High,23,0,23
1700045,Marlborough,1 LT Charles W. Whitcomb School,1274,1274,0
1700505,Marlborough,Marlborough High,429,0,429
1710310,Marshfield,Furnace Brook Middle,564,564,0
1710505,Marshfield,Marshfield High,380,0,380
1720005,Mashpee,Kenneth Coombs School,335,335,0
1720035,Mashpee,Quashnet School,478,478,0
1720505,Mashpee,Mashpee High,43,0,43
1730005,Mattapoisett,Center,212,212,0
1730010,Mattapoisett,Old Hammondtown,210,210,0
1740010,Maynard,Green Meadow,443,443,0
1740305,Maynard,Fowler School,224,224,0
1740505,Maynard,Maynard High,125,105,20
1750305,Medfield,Thomas Blake Middle,393,393,0
1750505,Medfield,Medfield Senior High,65,0,65
1760068,Medford,John J McGlynn Elementary School,497,497,0
1760130,Medford,Brooks School,454,454,0
1760140,Medford,Christopher Columbus,401,401,0
1760150,Medford,Milton Fuller Roberts,547,547,0
1760315,Medford,Madeleine Dugger Andrews,493,493,0
1760320,Medford,John J. McGlynn Middle School,467,467,0
1760505,Medford,Medford High,106,0,106
1760510,Medford,Curtis-Tufts,1,0,1
1760605,Medford,Medford Vocational Technical High,12,0,12
1770015,Medway,Burke/Memorial Elementary School,156,156,0
1770305,Medway,Medway Middle,660,660,0
1770505,Medway,Medway High,86,0,86
1780305,Melrose,Melrose Middle,352,352,0
1780505,Melrose,Melrose High,47,0,47
1810050,Methuen,Comprehensive Grammar School,1,1,0
1810055,Methuen,Tenney Grammar School,1,1,0
1810505,Methuen,Methuen High,114,0,114
1820008,Middleborough,Henry B. Burkland Elementary School,570,570,0
1820010,Middleborough,Mary K. Goode Elementary School,587,587,0
1820011,Middleborough,Memorial Early Childhood Center,209,209,0
1820305,Middleborough,John T. Nichols Middle,783,783,0
1820505,Middleborough,Middleborough High,320,0,320
1840003,Middleton,Fuller Meadow,146,146,0
1840005,Middleton,Howe-Manning,400,400,0
1850090,Milford,Woodland,639,639,0
1850305,Milford,Stacy Middle,785,785,0
1850505,Milford,Milford High,130,0,130
1860017,Millbury,Elmwood Street,512,512,0
1860025,Millbury,Raymond E. Shaw Elementary,434,434,0
1860505,Millbury,Millbury Junior/Senior High,394,251,143
1870020,Millis,Millis Middle,62,62,0
1870505,Millis,Millis High School,95,0,95
1890410,Milton,Charles S Pierce Middle,458,458,0
1890505,Milton,Milton High,268,0,268
1910025,Monson,Quarry Hill Community School,325,325,0
1910310,Monson,Granite Valley Middle,253,253,0
1910505,Monson,Monson High School,27,0,27
1970005,Nantucket,Nantucket Elementary,684,684,0
1970505,Nantucket,Nantucket High,10,0,10
1980305,Natick,J F Kennedy Middle School,56,56,0
1980505,Natick,Natick High,107,0,107
1990405,Needham,Pollard Middle,402,402,0
1990410,Needham,High Rock School,372,372,0
1990505,Needham,Needham High,98,0,98
2010405,New Bedford,Keith Middle School,1,1,0
2010410,New Bedford,Normandin Middle School,2,2,0
2010505,New Bedford,New Bedford High,410,0,410
2010515,New Bedford,Whaling City Junior/Senior High School,12,0,12
2040505,Newburyport,Newburyport High,56,0,56
2070505,Newton,Newton North High,326,0,326
2070510,Newton,Newton South High,217,0,217
2080015,Norfolk,H Olive Day,1,1,0
2090505,North Adams,Drury High,49,0,49
2100410,Northampton,John F Kennedy Middle School,396,396,0
2100505,Northampton,Northampton High,66,0,66
2110305,North Andover,North Andover Middle,1098,1098,0
2110505,North Andover,North Andover High,325,0,325
2120007,North Attleborough,Amvet Boulevard,2,2,0
2120010,North Attleborough,Falls,1,1,0
2120030,North Attleborough,Community,2,2,0
2120505,North Attleborough,North Attleboro High,238,0,238
2130015,Northborough,Fannie E Proctor,1,1,0
2140001,Northbridge,W Edward Balmer,517,517,0
2140005,Northbridge,Northbridge Elementary,1,1,0
2140505,Northbridge,Northbridge High,174,0,174
2150505,North Brookfield,North Brookfield High,1,1,0
2170305,North Reading,North Reading Middle,425,425,0
2170505,North Reading,North Reading High,105,0,105
2180010,Norton,L G Nourse Elementary,272,272,0
2180015,Norton,J C Solmonese,390,390,0
2180060,Norton,Henri A. Yelle,373,373,0
2180305,Norton,Norton Middle,587,587,0
2180505,Norton,Norton High,105,0,105
2190005,Norwell,Grace Farrar Cole,244,244,0
2190020,Norwell,William G Vinal,249,249,0
2190405,Norwell,Norwell Middle School,226,226,0
2190505,Norwell,Norwell High,46,0,46
2200305,Norwood,Dr. Philip O. Coakley Middle School,460,460,0
2200505,Norwood,Norwood High,25,0,25
2210005,Oak Bluffs,Oak Bluffs Elementary,278,278,0
2230010,Orange,Dexter Park,242,242,0
2230015,Orange,Fisher Hill,195,195,0
2240005,Orleans,Orleans Elementary,220,220,0
2260405,Oxford,Oxford Middle,1,1,0
2260505,Oxford,Oxford High,105,53,52
2270008,Palmer,Old Mill Pond,631,631,0
2270505,Palmer,Palmer High,121,121,0
2290305,Peabody,J Henry Higgins Middle,908,908,0
2290510,Peabody,Peabody Veterans Memorial High,203,0,203
2300005,Pelham,Pelham Elementary,124,124,0
2310305,Pembroke,Pembroke Community Middle School,169,169,0
2310505,Pembroke,Pembroke High School,154,0,154
2340005,Petersham,Petersham Center,112,112,0
2360505,Pittsfield,Pittsfield High,23,0,23
2360510,Pittsfield,Taconic High,69,0,69
2390005,Plymouth,Cold Spring,250,250,0
2390010,Plymouth,Hedge,216,216,0
2390011,Plymouth,Federal Furnace School,408,408,0
2390012,Plymouth,Indian Brook,562,562,0
2390015,Plymouth,Manomet Elementary,299,299,0
2390030,Plymouth,Nathaniel Morton Elementary,582,582,0
2390046,Plymouth,South Elementary,540,540,0
2390047,Plymouth,West Elementary,387,387,0
2390305,Plymouth,Plymouth South Middle,250,250,0
2390405,Plymouth,Plymouth Commun Intermediate,161,161,0
2390505,Plymouth,Plymouth North High,153,0,153
2390515,Plymouth,Plymouth South High,43,0,43
2400010,Plympton,Dennett Elementary,92,92,0
2430305,Quincy,Atlantic Middle,152,152,0
2430310,Quincy,Broad Meadows Middle,373,373,0
2430315,Quincy,Central Middle,648,648,0
2430320,Quincy,Reay E Sterling Middle,156,156,0
2430325,Quincy,Point Webster Middle,176,176,0
2430505,Quincy,Quincy High,92,0,92
2430510,Quincy,North Quincy High,232,0,232
2460305,Reading,Arthur W Coolidge Middle,104,104,0
2460310,Reading,Walter S Parker Middle,56,56,0
2460505,Reading,Reading Memorial High,194,0,194
2480003,Revere,A. C. Whelan Elementary School,732,732,0
2480013,Revere,Beachmont Veterans Memorial School,330,330,0
2480014,Revere,Rumney Marsh Academy,194,194,0
2480025,Revere,Abraham Lincoln,573,573,0
2480035,Revere,Staff Sargent James J. Hill Elementary School,693,693,0
2480050,Revere,Paul Revere,478,478,0
2480056,Revere,Garfield Elementary School,724,724,0
2480057,Revere,Garfield Middle School,236,236,0
2480305,Revere,Susan B. Anthony Middle School,566,566,0
2480505,Revere,Revere High,456,0,456
2480520,Revere,Seacoast School,35,0,35
2490005,Richmond,Richmond Consolidated,158,158,0
2510305,Rockland,John W Rogers Middle,155,155,0
2510505,Rockland,Rockland Senior High,10,0,10
2520005,Rockport,Rockport Elementary,385,385,0
2520305,Rockport,Rockport Middle,166,166,0
2520510,Rockport,Rockport High,40,0,40
2580030,Salem,Horace Mann Laboratory,46,46,0
2580505,Salem,Salem High,4,0,4
2580515,Salem,Salem Prep High School,7,0,7
2610002,Sandwich,Forestdale School,1,1,0
2610025,Sandwich,Oak Ridge,891,891,0
2610305,Sandwich,Sandwich STEM Academy,33,33,0
2610505,Sandwich,Sandwich High,249,0,249
2620305,Saugus,Belmonte Saugus Middle,492,492,0
2620505,Saugus,Saugus High,77,0,77
2630010,Savoy,Emma L Miller Elementary School,51,51,0
2640305,Scituate,Gates Intermediate School,472,472,0
2640505,Scituate,Scituate High School,31,0,31
2650015,Seekonk,Mildred Aitken School,1,1,0
2650405,Seekonk,Dr. Kevin M. Hurley Middle School,250,250,0
2650505,Seekonk,Seekonk High,74,0,74
2660305,Sharon,Sharon Middle,565,565,0
2660505,Sharon,Sharon High,174,0,174
2690010,Sherborn,Pine Hill,408,408,0
2710005,Shrewsbury,Beal School,320,320,0
2710025,Shrewsbury,Walter J Paton,20,20,0
2710305,Shrewsbury,Sherwood Middle School,411,411,0
2710505,Shrewsbury,Shrewsbury Sr High,213,0,213
2720005,Shutesbury,Shutesbury Elementary,105,105,0
2730305,Somerset,Somerset Middle School,607,607,0
2740505,Somerville,Somerville High,82,0,82
2760008,Southborough,Mary E Finn School,1,1,0
2760305,Southborough,P Brent Trottier,14,14,0
2770005,Southbridge,Charlton Street,71,71,0
2770315,Southbridge,Southbridge Middle School,320,320,0
2770515,Southbridge,Southbridge High School,167,0,167
2780305,South Hadley,Michael E. Smith Middle School,430,430,0
2780505,South Hadley,South Hadley High,28,0,28
2810005,Springfield,Springfield Public Day Elementary School,80,80,0
2810010,Springfield,Edward P. Boland School,490,490,0
2810015,Springfield,Thomas M Balliet,233,233,0
2810020,Springfield,Samuel Bowles,280,280,0
2810023,Springfield,Milton Bradley School,424,424,0
2810025,Springfield,Brightwood,282,282,0
2810030,Springfield,Elias Brookings,263,263,0
2810035,Springfield,Daniel B Brunton,394,394,0
2810045,Springfield,William N. DeBerry,243,243,0
2810050,Springfield,Hiram L Dorman,278,278,0
2810055,Springfield,Rebecca M Johnson,555,555,0
2810060,Springfield,Margaret C Ells,48,48,0
2810065,Springfield,Glenwood,274,274,0
2810068,Springfield,Glickman Elementary,298,298,0
2810075,Springfield,Frank H Freedman,271,271,0
2810080,Springfield,Frederick Harris,456,456,0
2810085,Springfield,Homer Street,361,361,0
2810095,Springfield,Alfred G. Zanetti Montessori Magnet School,276,276,0
2810100,Springfield,Indian Orchard Elementary,493,493,0
2810110,Springfield,Kensington International School,255,255,0
2810115,Springfield,Liberty,233,233,0
2810120,Springfield,Lincoln,321,321,0
2810125,Springfield,Mary A. Dryden Veterans Memorial School,248,248,0
2810140,Springfield,Mary M Lynch,219,219,0
2810145,Springfield,Mary O Pottenger,376,376,0
2810155,Springfield,Mary M Walsh,260,260,0
2810160,Springfield,Sumner Avenue,445,445,0
2810165,Springfield,Arthur T Talmadge,231,231,0
2810175,Springfield,Alice B Beal Elementary,231,231,0
2810180,Springfield,Warner,219,219,0
2810185,Springfield,Washington,329,329,0
2810190,Springfield,White Street,363,363,0
2810195,Springfield,German Gerena Community School,500,500,0
2810320,Springfield,John J Duggan Middle,11,0,11
2810325,Springfield,Forest Park Middle,253,253,0
2810328,Springfield,John F Kennedy Middle,1,1,0
2810330,Springfield,M Marcus Kiley Middle,284,284,0
2810350,Springfield,STEM Middle Academy,1,1,0
2810355,Springfield,South End Middle School,124,124,0
2810360,Springfield,Balliet Middle School,2,2,0
2810365,Springfield,Chestnut Accelerated Middle School (North),111,111,0
2810366,Springfield,Chestnut Accelerated Middle School (South),1,1,0
2810367,Springfield,Chestnut Accelerated Middle School (Talented and Gifted),119,119,0
2810480,Springfield,Van Sickle Academy,2,2,0
2810500,Springfield,Springfield Central High,355,0,355
2810510,Springfield,High School Of Commerce,71,0,71
2810530,Springfield,Springfield High School of Science and Technology,102,61,42
2810550,Springfield,Springfield Public Day High School,27,0,27
2810620,Springfield,Roger L. Putnam Vocational Technical Academy,23,0,23
2840005,Stoneham,Colonial Park,227,227,0
2840025,Stoneham,Robin Hood,326,326,0
2840030,Stoneham,South,331,331,0
2840405,Stoneham,Stoneham Central Middle School,470,470,0
2840505,Stoneham,Stoneham High,148,0,148
2850010,Stoughton,Helen Hansen Elementary,238,238,0
2850014,Stoughton,Joseph R Dawe Jr Elementary,370,370,0
2850015,Stoughton,South Elementary,256,256,0
2850020,Stoughton,West Elementary,368,368,0
2850025,Stoughton,Joseph H Gibbons,368,368,0
2850405,Stoughton,O'Donnell Middle School,768,768,0
2850505,Stoughton,Stoughton High,326,0,326
2880305,Sudbury,Ephraim Curtis Middle,602,602,0
2890005,Sunderland,Sunderland Elementary,223,223,0
2900003,Sutton,Sutton Early Learning,203,203,0
2900005,Sutton,Sutton Elementary,328,328,0
2900305,Sutton,Sutton Middle School,362,362,0
2900510,Sutton,Sutton High School,7,0,7
2910005,Swampscott,Clarke,199,199,0
2910010,Swampscott,Hadley,292,292,0
2910020,Swampscott,Stanley,293,293,0
2910305,Swampscott,Swampscott Middle,711,711,0
2910505,Swampscott,Swampscott High,182,0,182
2920305,Swansea,Joseph Case Jr High,1,1,0
2920505,Swansea,Joseph Case High,189,2,187
2930042,Taunton,Joseph H Martin,705,705,0
2930305,Taunton,John F Parker Middle,443,443,0
2930315,Taunton,Benjamin Friedman Middle,775,775,0
2930505,Taunton,Taunton High,300,94,206
2930525,Taunton,Taunton Alternative High School,1,0,1
2950023,Tewksbury,John F. Ryan,527,527,0
2950305,Tewksbury,John W. Wynn Middle,301,301,0
2950505,Tewksbury,Tewksbury Memorial High,252,3,252
2960005,Tisbury,Tisbury Elementary,318,318,0
3000005,Truro,Truro Central,96,96,0
3010305,Tyngsborough,Tyngsborough Middle,126,126,0
3010505,Tyngsborough,Tyngsborough High School,97,0,97
3040005,Uxbridge,Taft Early Learning Center,385,385,0
3040015,Uxbridge,McCloskey Middle School,384,384,0
3040020,Uxbridge,Whitin Elementary School,408,408,0
3040515,Uxbridge,Gateway to College,2,0,2
3050005,Wakefield,Dolbeare,443,443,0
3050015,Wakefield,Woodville School,441,441,0
3050020,Wakefield,Greenwood,221,221,0
3050040,Wakefield,Walton,198,198,0
3050310,Wakefield,Galvin Middle School,988,988,0
3050505,Wakefield,Wakefield Memorial High,57,1,56
3070010,Walpole,Boyden,1,1,0
3070015,Walpole,Fisher,1,1,0
3070505,Walpole,Walpole High,43,0,43
3080404,Waltham,John F Kennedy Middle,160,160,0
3080415,Waltham,John W. McDevitt Middle School,184,184,0
3080505,Waltham,Waltham Sr High,32,0,32
3090505,Ware,Ware Junior/Senior High School,238,185,53
3100003,Wareham,John William Decas,587,587,0
3100305,Wareham,Wareham Middle,2,2,0
3100315,Wareham,Wareham Cooperative Alternative School,3,0,3
3100505,Wareham,Wareham Senior High,141,0,141
3140305,Watertown,Watertown Middle,540,540,0
3140505,Watertown,Watertown High,91,0,91
3150005,Wayland,Claypit Hill School,430,430,0
3150015,Wayland,Happy Hollow School,332,332,0
3150020,Wayland,Loker School,208,208,0
3150505,Wayland,Wayland High School,130,0,130
3160015,Webster,Park Avenue Elementary,781,781,0
3160315,Webster,Webster Middle School,552,550,2
3160505,Webster,Bartlett High School,117,0,117
3170048,Wellesley,Sprague Elementary School,1,0,1
3170505,Wellesley,Wellesley Sr High,160,0,160
3180005,Wellfleet,Wellfleet Elementary,97,97,0
3210045,Westborough,Mill Pond School,886,886,0
3210505,Westborough,Westborough High,181,10,178
3220005,West Boylston,Major Edwards Elementary,374,374,0
3220505,West Boylston,West Boylston Junior/Senior High,188,166,22
3230003,West Bridgewater,Rose L Macdonald,260,260,0
3230005,West Bridgewater,Spring Street School,79,79,0
3230305,West Bridgewater,Howard School,273,273,0
3230505,West Bridgewater,West Bridgewater Junior/Senior,64,0,64
3250015,Westfield,Franklin Ave,241,241,0
3250020,Westfield,Abner Gibbs,220,220,0
3250025,Westfield,Highland,409,409,0
3250033,Westfield,Munger Hill,404,404,0
3250036,Westfield,Paper Mill,417,417,0
3250040,Westfield,Southampton Road,445,445,0
3250055,Westfield,Russell Elementary School,182,182,0
3250305,Westfield,North Middle School,154,154,0
3250505,Westfield,Westfield High,80,0,80
3250605,Westfield,Westfield Technical Academy,85,0,85
3260330,Westford,Stony Brook School,1,1,0
3260505,Westford,Westford Academy,532,0,532
3300505,Weston,Weston High,229,0,229
3310030,Westport,Westport Elementary,362,362,0
3310515,Westport,Westport Junior/Senior High School,162,0,162
3320007,West Springfield,Philip G Coburn,226,226,0
3320010,West Springfield,John R Fausey,461,461,0
3320025,West Springfield,Memorial,229,229,0
3320030,West Springfield,Mittineague,161,161,0
3320040,West Springfield,Tatham,225,225,0
3320305,West Springfield,West Springfield Middle,814,814,0
3320505,West Springfield,West Springfield High,169,0,169
3350505,Westwood,Westwood High,98,0,98
3360310,Weymouth,Abigail Adams Middle School,2,2,0
3360505,Weymouth,Weymouth High School,258,0,258
3370005,Whately,Whately Elementary,120,120,0
3400020,Williamsburg,Anne T. Dunphy School,146,146,0
3410010,Williamstown,Williamstown Elementary,414,414,0
3420005,Wilmington,Boutwell,117,117,0
3420015,Wilmington,Wildwood,134,134,0
3420020,Wilmington,Woburn Street,407,407,0
3420025,Wilmington,Shawsheen Elementary,359,359,0
3420060,Wilmington,North Intermediate,268,268,0
3420080,Wilmington,West Intermediate,254,254,0
3420330,Wilmington,Wilmington Middle School,786,786,0
3420505,Wilmington,Wilmington High,78,0,78
3430040,Winchendon,Memorial,271,271,0
3430050,Winchendon,Toy Town Elementary,282,282,0
3430315,Winchendon,Murdock Middle School,290,290,0
3430405,Winchendon,Murdock Academy for Success,3,0,3
3430515,Winchendon,Murdock High School,44,0,44
3440305,Winchester,McCall Middle,1005,1005,0
3440505,Winchester,Winchester High School,186,0,186
3460015,Winthrop,William P. Gorman/Fort Banks Elementary,432,432,0
3460020,Winthrop,Arthur T. Cummings Elementary School,461,461,0
3460505,Winthrop,Winthrop High School,49,0,49
3470065,Woburn,Mary D Altavesta,1,1,0
3470405,Woburn,John F Kennedy Middle School,497,497,0
3470410,Woburn,Daniel L Joyce Middle School,494,494,0
3470505,Woburn,Woburn High,380,0,380
3480052,Worcester,Chandler Magnet,1,0,1
3480136,Worcester,Heard Street,1,1,0
3480215,Worcester,Rice Square,1,0,1
3480350,Worcester,Claremont Academy,109,0,109
3480503,Worcester,Burncoat Senior High,15,0,15
3480512,Worcester,Doherty Memorial High,190,0,190
3480515,Worcester,North High,177,0,177
3480520,Worcester,South High Community,11,0,11
3480605,Worcester,Worcester Technical High,53,0,53
3500003,Wrentham,Delaney,501,501,0
3500010,Wrentham,Charles E Roderick,444,444,0
4100205,Excel Academy Charter (District),Excel Academy Charter School,707,656,51
4130505,Four Rivers Charter Public (District),Four Rivers Charter Public School,90,50,40
4140305,Berkshire Arts and Technology Charter Public (District),Berkshire Arts and Technology Charter Public School,89,74,15
4160305,Boston Preparatory Charter Public (District),Boston Preparatory Charter Public School,2,0,2
4180305,Christa McAuliffe Charter Public (District),Christa McAuliffe Charter Public School,386,386,0
4280305,Brooke Charter School (District),Brooke Charter School,467,404,63
4290010,KIPP Academy Lynn Charter (District),KIPP Academy Lynn Charter School,40,0,40
4300305,Advanced Math and Science Academy Charter (District),Advanced Math and Science Academy Charter School,611,448,163
4320530,Cape Cod Lighthouse Charter (District),Cape Cod Lighthouse Charter School,77,77,0
4350305,Innovation Academy Charter (District),Innovation Academy Charter School,14,0,14
4360305,Community Charter School of Cambridge (District),Community Charter School of Cambridge,83,0,83
4370505,City on a Hill Charter Public School Circuit Street (District),City on a Hill Charter Public School Circuit Street,64,0,64
4410505,Sabis International Charter (District),Sabis International Charter School,1315,1095,220
4440205,Neighborhood House Charter (District),Neighborhood House Charter School,334,334,0
4450105,Abby Kelley Foster Charter Public (District),Abby Kelley Foster Charter Public School,759,725,34
4460550,Foxborough Regional Charter (District),Foxborough Regional Charter School,1073,966,107
4470205,Benjamin Franklin Classical Charter Public (District),Benjamin Franklin Classical Charter Public School,441,441,0
4490305,Boston Collegiate Charter (District),Boston Collegiate Charter School,216,179,37
4500105,Hilltown Cooperative Charter Public (District),Hilltown Cooperative Charter Public School,92,92,0
4530005,Holyoke Community Charter (District),Holyoke Community Charter School,601,601,0
4540205,Lawrence Family Development Charter (District),Lawrence Family Development Charter School,105,105,0
4560050,Lowell Community Charter Public (District),Lowell Community Charter Public School,626,626,0
4660550,Martha's Vineyard Charter (District),Martha's Vineyard Charter School,29,29,0
4680505,Ma Academy for Math and Science,Ma Academy for Math and Science School,16,0,16
4690505,MATCH Charter Public School (District),MATCH Charter Public School,274,274,0
4740505,Sizer School: A North Central Charter Essential (District),A North Central Charter Essential (District): Sizer School: A North Central Charter Essential School,108,0,108
4810550,Boston Renaissance Charter Public (District),Boston Renaissance Charter Public School,75,75,0
4820050,River Valley Charter (District),River Valley Charter School,104,104,0
4830305,Rising Tide Charter Public (District),Rising Tide Charter Public School,47,2,45
4840505,Roxbury Preparatory Charter (District),Roxbury Preparatory Charter School,282,0,282
4850485,Salem Academy Charter (District),Salem Academy Charter School,179,72,107
4860105,Seven Hills Charter Public (District),Seven Hills Charter School,478,478,0
4870550,Prospect Hill Academy Charter (District),Prospect Hill Academy Charter School,144,1,143
4880550,South Shore Charter Public (District),South Shore Charter Public School,30,18,12
4890505,Sturgis Charter Public (District),Sturgis Charter Public School,24,0,24
4910550,Atlantis Charter (District),Atlantis Charter School,807,806,1
4920005,Martin Luther King Jr. Charter School of Excellence (District),Martin Luther King Jr. Charter School of Excellence,351,351,0
4940205,Pioneer Charter School of Science (District),Pioneer Charter School of Science,222,131,91
4960305,Global Learning Charter Public (District),Global Learning Charter Public School,346,230,116
4990305,Hampden Charter School of Science (District),Hampden Charter School of Science,43,0,43
6000405,Acton-Boxborough,Raymond J Grey Junior High,782,782,0
6000505,Acton-Boxborough,Acton-Boxborough Regional High,118,0,118
6030004,Adams-Cheshire,Cheshire Elementary,2,2,0
6030505,Adams-Cheshire,Hoosac Valley Middle & High School,275,211,64
6050505,Amherst-Pelham,Amherst Regional High,141,0,141
6100005,Ashburnham-Westminster,Westminster Elementary,374,374,0
6100010,Ashburnham-Westminster,Meetinghouse School,160,160,0
6100025,Ashburnham-Westminster,Briggs Elementary,469,469,0
6100305,Ashburnham-Westminster,Overlook Middle School,118,118,0
6100505,Ashburnham-Westminster,Oakmont Regional High School,149,0,149
6150505,Athol-Royalston,Athol High,44,0,44
6160001,Ayer Shirley School District,Lura A. White Elementary School,355,355,0
6160002,Ayer Shirley School District,Page Hilltop Elementary School,481,481,0
6160305,Ayer Shirley School District,Ayer Shirley Regional Middle School,384,384,0
6160505,Ayer Shirley School District,Ayer Shirley Regional High School,117,0,117
6180035,Berkshire Hills,Muddy Brook Regional Elementary School,263,263,0
6180310,Berkshire Hills,Monument Valley Regional Middle School,281,281,0
6180505,Berkshire Hills,Monument Mt Regional High,54,0,54
6200505,Berlin-Boylston,Tahanto Regional High,12,0,12
6220008,Blackstone-Millville,John F Kennedy Elementary,294,294,0
6220010,Blackstone-Millville,Millville Elementary,212,212,0
6220015,Blackstone-Millville,A F Maloney,292,292,0
6220405,Blackstone-Millville,Frederick W. Hartnett Middle School,2,2,0
6220505,Blackstone-Millville,Blackstone Millville RHS,53,0,53
6250300,Bridgewater-Raynham,Williams Intermediate School,72,72,0
6250315,Bridgewater-Raynham,Raynham Middle School,87,87,0
6250320,Bridgewater-Raynham,Bridgewater Middle School,124,124,0
6250505,Bridgewater-Raynham,Bridgewater-Raynham Regional,449,0,449
6350305,Central Berkshire,Nessacus Regional Middle School,389,389,0
6350505,Central Berkshire,Wahconah Regional High,41,0,41
6400505,Concord-Carlisle,Concord Carlisle High,109,0,109
6450005,Dennis-Yarmouth,Ezra H Baker Innovation School,1,1,0
6450050,Dennis-Yarmouth,N H Wixon Innovation School,270,270,0
6450505,Dennis-Yarmouth,Dennis-Yarmouth Regional High,194,0,194
6500005,Dighton-Rehoboth,Dighton Elementary,451,451,0
6500010,Dighton-Rehoboth,Palmer River,560,560,0
6500305,Dighton-Rehoboth,Dighton Middle School,366,366,0
6500505,Dighton-Rehoboth,Dighton-Rehoboth Regional High School,3,0,3
6550405,Dover-Sherborn,Dover-Sherborn Regional Middle School,346,346,0
6550505,Dover-Sherborn,Dover-Sherborn Regional High,48,0,48
6580005,Dudley-Charlton Reg,Dudley Elementary,366,366,0
6580010,Dudley-Charlton Reg,Mason Road School,212,212,0
6580020,Dudley-Charlton Reg,Charlton Elementary,288,288,0
6580030,Dudley-Charlton Reg,Heritage School,495,495,0
6580305,Dudley-Charlton Reg,Dudley Middle School,596,596,0
6580310,Dudley-Charlton Reg,Charlton Middle School,705,705,0
6580505,Dudley-Charlton Reg,Shepherd Hill Regional High,77,0,77
6600305,Nauset,Nauset Regional Middle,442,442,0
6600505,Nauset,Nauset Regional High,43,0,43
6620020,Farmington River Reg,Farmington River Elementary,92,92,0
6650505,Freetown-Lakeville,Apponequet Regional High,106,0,106
6700505,Frontier,Frontier Regional,230,168,62
6720505,Gateway,Gateway Regional High,12,0,12
6730505,Groton-Dunstable,Groton Dunstable Regional,225,0,225
6740005,Gill-Montague,Gill Elementary,120,120,0
6740015,Gill-Montague,Hillcrest Elementary School,147,147,0
6740050,Gill-Montague,Sheffield Elementary School,207,207,0
6740310,Gill-Montague,Great Falls Middle,1,1,0
6750310,Hamilton-Wenham,Miles River Middle,1,1,0
6750505,Hamilton-Wenham,Hamilton-Wenham Regional High,21,0,21
6800305,Hampden-Wilbraham,Thornton Burgess,206,206,0
6800310,Hampden-Wilbraham,Wilbraham Middle,344,344,0
6800505,Hampden-Wilbraham,Minnechaug Regional High,102,0,102
6830505,Hampshire,Hampshire Regional High,19,0,19
6900505,King Philip,King Philip Regional High,31,0,31
6950505,Lincoln-Sudbury,Lincoln-Sudbury Regional High,500,0,500
6980010,Manchester Essex Regional,Manchester Memorial Elementary,357,357,0
6980020,Manchester Essex Regional,Essex Elementary,226,226,0
6980510,Manchester Essex Regional,Manchester Essex Regional High School,42,0,42
7000505,Martha's Vineyard,Martha's Vineyard Regional High,50,0,50
7050505,Masconomet,Masconomet Regional High School,230,0,230
7100001,Mendon-Upton,Memorial School,408,408,0
7100015,Mendon-Upton,Miscoe Hill School,503,503,0
7100179,Mendon-Upton,Henry P Clough,397,397,0
7100510,Mendon-Upton,Nipmuc Regional High,58,0,58
7120001,Monomoy Regional School District,Chatham Elementary School,253,253,0
7120002,Monomoy Regional School District,Harwich Elementary School,517,517,0
7120315,Monomoy Regional School District,Monomoy Regional Middle School,1,1,0
7120515,Monomoy Regional School District,Monomoy Regional High School,62,0,62
7150505,Mount Greylock,Mt Greylock Regional High,6,0,6
7170505,Mohawk Trail,Mohawk Trail Regional High,139,120,19
7200305,Narragansett,Narragansett Middle,268,268,0
7200505,Narragansett,Narragansett Regional High,85,0,85
7250010,Nashoba,Mary Rowlandson Elementary,445,445,0
7250020,Nashoba,Center School,564,564,0
7250025,Nashoba,Florence Sawyer School,624,624,0
7250305,Nashoba,Luther Burbank Middle School,144,144,0
7250310,Nashoba,Hale,37,37,0
7250505,Nashoba,Nashoba Regional,169,0,169
7300505,Northboro-Southboro,Algonquin Regional High,426,1,425
7350005,North Middlesex,Spaulding Memorial,422,422,0
7350010,North Middlesex,Ashby Elementary,207,207,0
7350030,North Middlesex,Hawthorne Brook,241,241,0
7350035,North Middlesex,Varnum Brook,571,571,0
7350310,North Middlesex,Nissitissit Middle School,253,253,0
7350505,North Middlesex,North Middlesex Regional,96,0,96
7400505,Old Rochester,Old Rochester Regional High,66,0,66
7450405,Pentucket,Pentucket Regional Middle,184,184,0
7450505,Pentucket,Pentucket Regional Sr High,1,0,1
7500006,Pioneer Valley,Bernardston Elementary,137,137,0
7500007,Pioneer Valley,Pearl E Rhodes Elementary,24,24,0
7500008,Pioneer Valley,Northfield Elementary,172,172,0
7500009,Pioneer Valley,Warwick Community School,52,52,0
7500505,Pioneer Valley,Pioneer Valley Regional,92,89,3
7530005,Quabbin,Hardwick Elementary,192,192,0
7530010,Quabbin,Hubbardston Center,316,316,0
7530020,Quabbin,New Braintree Grade,42,42,0
7530025,Quabbin,Oakham Center,135,135,0
7530030,Quabbin,Ruggles Lane,382,382,0
7530505,Quabbin,Quabbin Regional High School,110,0,110
7550505,Ralph C Mahar,Ralph C Mahar Regional,119,113,6
7600405,Silver Lake,Silver Lake Regional Middle School,1,1,0
7600505,Silver Lake,Silver Lake Regional High,199,0,199
7630505,Somerset Berkley Regional School District,Somerset Berkley Regional High School,71,0,71
7660505,Southwick-Tolland-Granville Regional School District,Southwick Regional School,42,0,42
7670040,Spencer-E Brookfield,Wire Village School,1,1,0
7670505,Spencer-E Brookfield,David Prouty High,103,0,103
7700405,Tantasqua,Tantasqua Regional Jr High,265,265,0
7700505,Tantasqua,Tantasqua Regional Sr High,73,0,73
7700605,Tantasqua,Tantasqua Regional Vocational,27,0,27
7730015,Triton,Salisbury Elementary,455,455,0
7730020,Triton,Newbury Elementary,424,424,0
7730025,Triton,Pine Grove,449,449,0
7730505,Triton,Triton Regional High School,70,0,70
7740020,Up-Island Regional,West Tisbury Elementary,329,329,0
7750505,Wachusett,Wachusett Regional High,171,0,171
7780005,Quaboag Regional,Warren Elementary,432,432,0
7780010,Quaboag Regional,West Brookfield Elementary,298,298,0
7780305,Quaboag Regional,Quaboag Regional Middle Innovation School,3,3,0
7780505,Quaboag Regional,Quaboag Regional High,89,0,89
7800310,Whitman-Hanson,Whitman Middle,443,443,0
7800315,Whitman-Hanson,Hanson Middle School,354,354,0
7800505,Whitman-Hanson,Whitman Hanson Regional,202,0,202
8010605,Assabet Valley Regional Vocational Technical,Assabet Valley Vocational High School,25,0,25
8050605,Blackstone Valley Regional Vocational Technical,Blackstone Valley,58,0,58
8060605,Blue Hills Regional Vocational Technical,Blue Hills Regional Vocational Technical,36,0,36
8150605,Cape Cod Regional Vocational Technical,Cape Cod Region Vocational Technical,3,0,3
8180605,Franklin County Regional Vocational Technical,Franklin County Technical,14,0,14
8210605,Greater Fall River Regional Vocational Technical,Diman Regional Vocational Technical High,664,0,664
8290605,South Middlesex Regional Vocational Technical,Joseph P Keefe Technical High School,32,0,32
8300605,Minuteman Regional Vocational Technical,Minuteman Regional High,99,0,99
8320605,Montachusett Regional Vocational Technical,Montachusett Regional Vocational Technical,246,0,246
8510605,Northern Berkshire Regional Vocational Technical,Charles McCann Vocational Technical,151,0,151
8520605,Nashoba Valley Regional Vocational Technical,Nashoba Valley Technical High School,9,0,9
8530605,Northeast Metropolitan Regional Vocational Technical,Northeast Metro Regional Vocational,7,0,7
8550605,Old Colony Regional Vocational Technical,Old Colony Regional Vocational Technical,283,0,283
8600605,Pathfinder Regional Vocational Technical,Pathfinder Vocational Technical,17,0,17
8720605,Southeastern Regional Vocational Technical,Southeastern Regional Vocational Technical,330,0,330
8780605,Tri-County Regional Vocational Technical,Tri-County Regional Vocational Technical,275,0,275
8850605,Whittier Regional Vocational Technical,Whittier Regional Vocational,59,0,59
9150705,Norfolk County Agricultural,Norfolk County Agricultural,268,0,268
35010505,Paulo Freire Social Justice Charter School (District),Paulo Freire Social Justice Charter School,1,0,1
35030205,Collegiate Charter School of Lowell (District),Collegiate Charter School of Lowell,609,609,0
35040505,City on a Hill Charter Public School Dudley Square (District),City on a Hill Charter Public School Dudley Square,53,0,53
35060505,Pioneer Charter School of Science II (PCSS-II) (District),Pioneer Charter School of Science II (PCSS-II),200,140,60
35070505,City on a Hill Charter Public School New Bedford (District),City on a Hill Charter Public School New Bedford,76,0,76
39020900,TEC Connections Academy Commonwealth Virtual School District,TEC Connections Academy Commonwealth Virtual School,553,451,102
0,Massachusetts,Massachusetts,238936,204688,34364